{
    "name": "Archdale Castle",
    "author": "Nexus",

    "map": [
        [1, 1, 1, 1, 1, 1, 1, 1, 1, 1, 1, 1, 1, 1, 1, 1, 1, 1],
        [1, 0, 0, 0, 0, 0, 0, 0, 1, 1, 1, 1, 6, 6, 6, 6, 6, 1],
        [1, 0, 0, 0, 0, 0, 0, 0, 1, 1, 1, 1, 6, 6, 6, 6, 6, 1],
        [1, 0, 0, 0, 0, 0, 0, 0,12,12,12,12, 6, 6, 6, 6, 6, 1],
        [1, 0, 0, 0, 0, 0, 0, 0, 1, 1, 1, 1, 1, 1, 1, 1, 1, 1],
        [1, 0, 0, 0, 0, 0, 0, 1, 1, 1,10,10,10,10,10,10,10, 1],
        [1, 0, 0, 0, 0, 0, 0, 1,10,10,10, 0, 0, 0, 0, 0,10, 1],
        [1, 0, 0, 0, 0, 0, 0, 1,10,10,10, 0,10,10,10, 0,10, 1],
        [1, 0, 0, 0, 0, 0, 0, 1,10,10,10, 0,10,10,10, 0,10, 1],
        [1, 0, 0, 0, 0, 0, 0, 0, 0, 0, 0, 0,10,10,10, 0,11, 1],
        [1,10,10,10,10,10,10,10,10,10,10,10,10,10,10,10,10, 1],
        [1, 1, 1, 1, 1, 1, 1, 1, 1, 1, 1, 1, 1, 1, 1, 1, 1, 1]
    ]
}