{
    "name": "Dungeon of Doom",
    "author": "Nexus",

    "map": [
        [1, 1, 1, 1, 1, 1, 1, 1, 1, 1 , 1, 1 , 1 , 1 , 1 , 1 , 1 , 1],
        [1, 0, 0, 0, 0, 0, 0, 0, 0, 10, 0, 0 , 0 , 0 , 0 , 0 , 0 , 1],
        [1, 0, 0, 0, 0, 0, 0, 0, 0, 10, 0, 0 , 0 , 0 , 0 , 0 , 0 , 1],
        [1, 0, 0, 0, 0, 0, 0, 0, 0, 10, 0, 0 , 0 , 0 , 0 , 0 , 0 , 1],
        [1, 0, 0, 0, 0, 0, 0, 0, 0, 10, 0, 0 , 0 , 0 , 0 , 0 , 11, 1],
        [1, 1, 1, 1, 1, 1, 1, 1, 9, 10, 0, 0 , 0 , 10, 10, 10, 10, 1],
        [1, 0, 0, 0, 0, 0, 0, 0, 0, 10, 0, 0 , 0 , 10, 10, 10, 10, 1],
        [1, 6, 0, 0, 1, 1, 1, 0, 0, 10, 0, 10, 10, 10, 10, 10, 10, 1],
        [1, 1, 1, 1, 1, 1, 1, 0, 0, 10, 0, 0 , 0 , 0 , 0 , 0 , 10, 1],
        [1, 1, 1, 1, 1, 1, 1, 0, 0, 10, 0, 0 , 0 , 0 , 0 , 0 , 10, 1],
        [1, 1, 1, 1, 1, 1, 1, 0, 0, 0 , 0, 10, 10, 10, 10, 10, 10, 1],
        [1, 1, 1, 1, 1, 1, 1, 1, 1, 1 , 1, 1 , 1 , 1 , 1 , 1 , 1 , 1]
    ]
}