{
    "name": "Spikes of Treasure",
    "author": "Nexus & Removed",

    "map": [
        [1, 1 , 1, 1, 1, 1, 1, 1, 1, 1 , 1 , 1, 1 , 1, 1, 1 , 1 , 1],
        [1, 0 , 0, 0, 0, 0, 0, 0, 0, 10, 0 , 0, 0 , 0, 0, 12, 11, 1],
        [1, 0 , 0, 0, 0, 0, 0, 0, 0, 10, 0 , 0, 0 , 0, 0, 12, 12, 1],
        [1, 0 , 0, 0, 0, 0, 0, 0, 0, 10, 0 , 0, 0 , 0, 0, 0 , 0 , 1],
        [1, 0 , 0, 0, 0, 0, 0, 0, 0, 10, 0 , 0, 12, 0, 0, 0 , 0 , 1],
        [1, 12, 1, 1, 1, 1, 1, 1, 1, 10, 0 , 0, 0 , 0, 0, 0 , 0 , 1],
        [1, 0 , 0, 0, 0, 0, 0, 0, 0, 10, 0 , 0, 0 , 0, 0, 0 , 0 , 1],
        [1, 0 , 0, 0, 1, 0, 1, 0, 0, 10, 0 , 0, 0 , 0, 0, 0 , 0 , 1],
        [1, 0 , 0, 0, 1, 0, 1, 0, 0, 10, 0 , 0, 12, 0, 0, 0 , 0 , 1],
        [1, 0 , 0, 0, 1, 0, 1, 0, 0, 10, 12, 0, 0 , 0, 0, 0 , 0 , 1],
        [1, 0 , 6, 0, 1, 0, 1, 0, 0, 12, 12, 0, 0 , 0, 0, 0 , 0 , 1],
        [1, 1 , 1, 1, 1, 1, 1, 1, 1, 1 , 1 , 1, 1 , 1, 1, 1 , 1 , 1]
    ]
}